10
10
----------
--++------
-++-------
--+-------
----------
----------
----------
----------
----------
----------